111111111111
1P00001C0001
100000K000E1
1CK000000001
111111111111
